###############################################################################################################################################################################################################################################################
###############################################################################################################################################################################################################################################################
...............................................................................................................................................................................................................................................................
...............................................................................................................................................................................................................................................................
...............................................................................................................................................................................................................................................................
...............................................................................................................................................................................................................................................................
...............................................................................................................................................................................................................................................................
...............................................................................................................................................................................................................................................................
...............................................................................................................................................................................................................................................................
...............................................................................................................................................................................................................................................................
...............................................................................................................................................................................................................................................................
...............................................................................................................................................................................................................................................................
...............................................................................................................................................................................................................................................................
................................................................................................................................^..............................................................................................................................
...............................................................................................................................^#..............................................................................................................................
...............................................................................................................................^#...........................................................................................................................**.
......................................................................................####.......^.............................^#..........................................................................^#####...........................................**.
..............................................................................................####...........#..................^.......................................^...............................^##.................................................**.
...............@............................^^...........^#..^........^...^....####...^^^^^^^^^^^..........^^^^^...........^........^.....^###......^^......^........^###...........^^#....^.........^##.......^^^.............^............................**.
###############################################################################################################################################################################################################################################################
###############################################################################################################################################################################################################################################################
