###############################################################################################################################################################################################################################################################
###############################################################################################################################################################################################################################################################
......................................................................................................................................................................#........................................................................................
......................................................................................................................................................................#........................................................................................
......................................................................................................................................................................#........................................................................................
......................................................................................................................................................................#........................................................................................
......................................................................................................................................................................#........................................................................................
......................................................................................................................................................................#........................................................................................
......................................................................................................................................................................#........................................................................................
..........................................................................................................................^...........................................#........................................................................................
...................................................................................................................################....#######........................#........................................................................................
..................................................................................................................^...................................................#........................................................................................
....................................................................................................^........#####...............................^....................#........................................................................................
................................................................................................#####.......^...................................^#....................#.....................................................................................**.
........................................................................................#####...........####....................................^#....................^.....................................^.......................#.......................**.
..........................................................^..................^######............................................................^#.....................................................^#####............^..........^.......................**.
.....@......................^.........^............^#######.......^......^##########^^^^^^^^^^^^^^^^^^^^^^^^^^^^^^^.............................^#.............^....................^^.............^#########^........^#####^...............................**.
###############################################################################################################################################################################################################################################################
###############################################################################################################################################################################################################################################################
